{
  "name": "Level 1",
  "scoreGoal": 20,
  "player": {
    "x": 8,
    "y": 8
  },
  "enemies": [
    { "type": "CommandoEnemy", "x": 3, "y": 2 },
    { "type": "CommandoEnemy", "x": 9, "y": 10 },
    { "type": "CommandoEnemy", "x": 1, "y": 3 }
  ],
  "rows": [
    "####################",
    "#_*_______________*#",
    "#_#_##########_#___#",
    "#_#_#____#____#_#_*#",
    "#_#_#_##_#_##_#____#",
    "#_#_#_#__*_#___#_###",
    "#_#_#_#_###_#_#___##",
    "#_*_#_#_____#_#_####",
    "#_###_#_###_#_____##",
    "#_____#_#_#######_#",
    "#_#####_#_#_______##",
    "#_#___#_#_#######_##",
    "#_#_#_#_______#___##",
    "#_#_#_#######_#_####",
    "#_#_#_______#_#___##",
    "#_#_#######_#_#_#_##",
    "#_#_______#_#_#_#_##",
    "#_#######_#_#_#_#_##",
    "#_________#_#_*_#__#",
    "####################"
  ]
}
