WWWWWWWWWWWWWWWWWWWW
WFFFFFFFFFFFFFFFFFFW
WFFFFFFFFFFFFFFFFFFW
WFFFFFFFFFFFFFFFFFFW
WFFFFSFFFFFFFFFFFFFW
WFFFFFFFFFFFFFFFFFFW
WFFFFFFFFFFFFSFFFFFW
WFFFFFFFFFFFFFFFFFFW
WFFFFFFFFFFFFFFFFFFW
WFFFFFFFFFFFFFFFFFFW
WFFFFFFFFFFFFFFFFFFW
WFFFFSFFFFFFFFFFFFFW
WFFFFFFFFFFFFFFFFFFW
WFFFFFFFFFFFFSFFFFFW
WFFFFFFFFFFFFFFFFFFW
WFFFFFFFFFFFFFFFFFFW
WFFFFFFFFFFFFFFFFFFW
WFFFFFFFFFFFFFFFFFFW
WFFFFFFFFFFFFFFFFFFW
WWWWWWWWWWWWWWWWWWWW