WWWWWWWWWWWWWWWWWWWW
WFFFFFFFFFFFFFFFFFFW
WFFFFFFFFFFFFFFFFFFW
WFFFFFFFFFFFFFFFFFFW
WFFFFSFFFFFFFFFFFFFW
WFFWFFFFFFFFFFFFFFFW
WFFWFFFFFFFFFSFFFFFW
WFFWFFFFFFFFFFFFFFFW
WFFWFFFFFFFFFFFFFFFW
WFFWFFFFFFFFFFFFFFFW
WFFWFFFFFFFFFFFFFFFW
WFFWFSFFFFFFFFFFFFFW
WFFWFFFFFFFFFFFFFFFW
WFFWFFFFFFFFFSFFFFFW
WFFWFFFFFFFFFFFFFFFW
WFFWFFFFFFFFFFFFFFFW
WFFWFFFFFFFFFFFFFFFW
WFFWFFFFFFFFFFFFFFFW
WFFFFFFFFFFFFFFFFFFW
WWWWWWWWWWWWWWWWWWWW