####################
#_*____________#__*#
#_#_##########___#_#
#_#_#____#____#_#_*#
#_#_#_##_#_##_#____#
#_#_#_#__*_#_#_#_###
#_#_#_#_###_#_#___##
#_*_#_#_____#_######
#_###_#_###_#_____##
#_____#_#_#_########
#_#####_#_#_______##
#_#___#_#_#######_##
#_#_#_#_______#___##
#_#_#_#######_#_####
#_#_#___#___#_#___##
#_#_#######_#_#_#_##
#_#_______#_#_#_#_##
#_#######_#_#_#_#_##
#_________#_#_*_#__#
####################