{
  "name": "Level 2",
  "scoreGoal": 1000,
  "player": {
    "x": 8,
    "y": 8
  },
  "enemies": [
    { "type": "AdvancedEnemy", "x": 9, "y": 10 },
    { "type": "AdvancedEnemy", "x": 3, "y": 2 },
    { "type": "AdvancedEnemy", "x": 1, "y": 3 }
  ],
  "rows": [
    "#########################",
    "#_______________________#",
    "#_#_#_#_#_#_#_#_#_#_#_#_#",
    "#_#_#_#_#_#_#_#_#_#_#_#_#",
    "#_#_#_#_#_#_#_#_#_#_#_#_#",
    "#_______________________#",
    "#_#_#_#_#_#_#_#_#_#_#_#_#",
    "#_#_#_#_#_#_#_#_#_#_#_#_#",
    "#_#_#_#_#_#_#_#_#_#_#_#_#",
    "#_______________________#",
    "#_#_#_#_#_#_#_#_#_#_#_#_#",
    "#_#_#_#_#_#_#_#_#_#_#_#_#",
    "#_#_#_#_#_#_#_#_#_#_#_#_#",
    "#_______________________#",
    "#_#_#_#_#_#_#_#_#_#_#_#_#",
    "#_#_#_#_#_#_#_#_#_#_#_#_#",
    "#_#_#_#_#_#_#_#_#_#_#_#_#",
    "#_______________________#",
    "#_#_#_#_#_#_#_#_#_#_#_#_#",
    "#_#_#_#_#_#_#_#_#_#_#_#_#",
    "#_#_#_#_#_#_#_#_#_#_#_#_#",
    "#_______________________#",
    "#_#_#_#_#_#_#_#_#_#_#_#_#",
    "#_______________________#",
    "#########################"
  ]
}
