{
  "name": "Level 1",
  "scoreGoal": 1000,
  "player": {
    "x": 8,
    "y": 8
  },
  "enemies": [
    { "type": "CommandoLeaderEnemy", "x": 9, "y": 10 },
    { "type": "CommandoEnemy", "x": 3, "y": 2 },
    { "type": "CommandoEnemy", "x": 2, "y": 15 }
  ],
  "rows": [
    "#########################",
"#___________#___________#",
"#_#####_###_#_###_#####_#",
"#_#___#_#_______#_#___#_#",
"#_#_#_#_####_####_#_#_#_#",
"#_____#____#_#____#_____#",
"#####_####_#_#_####_#####",
"#_____##___#_#___##____##",
"#_###_##_#######_##_###_#",
"#___#________________#__#",
"###_#_###_#####_###_#_###",
"#_______#_______#_______#",
"###_#_###_##_##_###_#_###",
"#___#______#______#___#_#",
"#_###_##_#######_##_###_#",
"##____##___#_#___##____##",
"#####_####_#_#_####_#####",
"#_____#____#_#____#_____#",
"#_#_#_#_####_####_#_#_#_#",
"#_#___#_#_______#_#___#_#",
"#_#####_###_#_###_#####_#",
"#___________#___________#",
"#_#####_####_####_#####_#",
"#_______________________#",
"#########################"
  ]
}
